1111111111111111
1000000100000001
1000000100000001
1000000100000001
1000000110000001
1000000010000001
1000000010000001
1000011110000001
1000000000000001
1000000000000001
1000000000000001
1000000000000001
1000000000000001
1000000000000001
1000000000000001
1111111111111111