121212121111111111111111
100000010000001111111101
100100010000001111111101
200000010000111111110001
200200011000011111111001
100000001000111111110001
100000001000011111111001
200002222000000000000001
100000000000000000000001
200000000000211111110001
100000000000211111110001
200003000000111111110001
100000000000111111110001
100000000000111111110001
100003000000111111110001
100000000000111111110001
100000000000111111110001
100000000000111111110001
100000000000111111110001
100000000000111111110001
100000000000111111110001
100000000000111111110001
100000000000111111110001
111111111111111111111111