111111111111111111111111
100000010000001111111101
100100010000001111111101
100000010000111111110001
100200011000011111111001
100000001000111111110001
100000001000011111111001
100002222000000000000001
100000000000000000000001
100000000000211111110001
100000000000211111110001
100000000000111111110001
100000000000111111110001
100000000000111111110001
100000000000111111110001
100000000000111111110001
100000000000111111110001
100000000000111111110001
100000000000111111110001
100000000000111111110001
100000000000111111110001
100000000000111111110001
100000000000111111110001
111111111111111111111111