113123333377777777777331
100000000000000000000001
100000080000000000000001
100000000000000000000001
100000009000000000000004
100000000070000000000001
160000000000000000000005
100700000060000000000001
100007000000000000000001
100000000050000000000001
100000000000000000000009
100000000040000000000001
100000000000000000000001
100000000030000020010008
100000000000000000000001
100000000000000000000001
111155555577777777777555